0,0,0,0,W,W,0,0,0
0,0,0,0,0,0,0,0,0
0,0,0,E1,0,0,0,0,0
W,0,0,0,0,0,0,0,0
A,0,0,0,0,E3,0,0,0
W,0,0,T,0,0,0,0,0
0,P,0,0,0,0,0,0,0
0,0,0,0,0,0,0,0,0
0,0,0,E2,0,0,0,0,0
